{
    "grid": [
        "#################",
        "######......#####",
        "######.##...#####",
        "######.##.....###",
        "#......#####....#",
        "#####...####....#",
        "#####...#####...#",
        "#######.##..#####",
        "#######.....#####",
        "#######.....#####",
        "########...######",
        "#################"
    ],
    "start": [4, 1],

    "goal": [5, 14]
}