{
    "grid": [
        "#####################",
        "#...#################",
        "#......##############",
        "#.........###########",
        "##.........##########",
        "######.....##########",
        "#######...###########",
        "#####################"
    ],
    "start": [1, 1],

    "goal": [4, 7]
}