{
    "grid": [
        "#######",
        "#.....#",
        "#.....#",
        "#.....#",
        "#.....#",
        "#.F...#",
        "#######"
    ],
    "start": [2, 2],
    "goal": [4, 4]
}
